+--+--#--#--+
|p          |
+  +--+  #  +
|  |     |  |
+  #  *--*--+
#  |        #
+  +--+--+  +
|        | g|
+--*#-*--*--+